51
27
203 204 205 205 205 205 205 205 205 205 205 205 205 205 205 205 205 205 205 205 205 205 205 205 205 205 205 205 205 205 205 206 207 208 209 210 257 257 257 257 257 257 257 257 257 257 257 257 257 257 257 
211 219 220 221 222 223 224 225 226 227 227 227 227 227 227 227 227 227 227 227 227 227 227 227 227 227 227 227 227 227 227 227 228 229 230 212 257 257 257 257 257 257 257 257 257 257 257 257 257 257 257 
211 2 1 1 1 1 1 1 1 1 1 8 0 0 0 0 0 0 0 0 0 0 0 0 0 213 0 0 0 3 213 0 0 0 3 212 257 257 257 257 257 257 257 257 257 257 257 257 257 257 257 
211 2 1 1 1 1 1 1 1 1 0 213 2 0 0 0 0 0 0 0 0 0 0 0 0 214 0 0 213 3 214 0 255 213 3 212 257 257 257 257 257 257 257 257 257 257 257 257 257 257 257 
211 235 233 233 233 234 0 0 1 1 231 214 4 6 6 6 6 6 6 6 6 6 6 6 12 214 0 0 214 3 214 0 3 214 3 212 257 257 257 257 257 257 257 257 257 257 257 257 257 257 257 
211 2 1 1 1 1 231 0 1 1 1 216 237 238 239 227 227 224 225 226 227 228 229 230 2 214 0 231 214 3 214 231 3 214 3 212 257 257 257 257 257 257 257 257 257 257 257 257 257 257 257 
211 2 1 1 1 1 1 1 1 1 0 218 2 0 0 0 0 0 0 0 0 0 0 213 2 214 0 0 214 3 214 0 3 214 3 212 257 257 257 257 203 204 205 206 207 208 209 210 257 257 257 
211 2 1 1 1 1 1 1 1 1 231 217 2 0 0 231 0 0 0 231 0 0 0 214 2 214 231 0 214 3 214 0 255 214 3 212 257 257 257 257 211 0 0 0 0 0 0 212 257 257 257 
211 2 1 1 1 1 232 234 1 1 1 214 2 0 0 0 0 0 0 0 0 0 0 214 2 214 0 0 214 3 214 0 3 214 3 212 257 257 257 257 211 0 0 0 0 10 0 212 257 257 257 
211 2 1 1 1 1 1 1 1 1 1 214 2 231 0 0 0 0 0 0 0 231 0 214 2 215 0 231 214 3 214 231 3 214 3 212 257 257 257 257 211 0 0 0 0 13 0 212 257 257 257 
211 235 233 233 233 233 233 234 0 0 0 214 2 0 0 0 0 0 0 0 0 0 0 214 2 0 0 0 214 3 214 0 3 214 3 212 257 257 257 257 200 202 202 202 202 202 202 201 257 257 257 
211 2 1 1 1 1 1 1 1 0 231 214 235 0 0 0 0 0 0 0 0 0 231 214 243 244 246 247 214 3 215 0 255 214 3 212 257 257 257 257 257 257 257 257 257 257 257 257 257 257 257 
211 2 1 1 1 1 1 1 1 1 1 214 2 0 0 0 0 0 0 0 0 0 0 214 2 0 0 0 215 0 0 0 3 215 3 212 257 257 257 257 257 257 257 257 257 257 257 257 257 257 257 
211 2 1 1 1 1 1 232 233 233 234 214 2 231 0 0 0 0 0 0 0 231 0 215 2 236 0 0 248 249 250 251 252 252 3 212 257 257 257 257 257 257 257 257 257 257 257 257 257 257 257 
211 2 1 1 1 1 1 1 1 1 1 214 4 6 6 6 6 6 6 6 6 6 6 5 4 6 6 6 6 6 6 6 6 6 5 212 257 257 257 257 257 257 257 257 257 257 257 257 257 257 257 
211 235 234 1 1 1 1 1 1 1 1 214 248 254 254 254 254 254 254 254 254 254 254 254 254 254 254 254 254 254 254 254 254 254 252 212 257 257 257 257 257 257 257 257 257 0 0 0 0 0 0 
211 2 0 0 0 0 0 0 0 0 0 214 2 0 11 6 6 6 6 6 6 6 6 6 6 6 6 6 6 6 12 0 0 0 0 212 257 257 257 257 257 257 257 257 257 0 0 0 0 0 0 
211 2 0 232 234 0 0 0 0 0 0 214 2 0 5 243 253 253 244 245 246 253 253 253 253 253 253 253 253 247 4 0 0 0 0 212 257 257 257 257 257 257 257 257 257 0 0 0 0 0 0 
211 2 0 0 0 0 0 0 232 234 0 214 2 0 240 241 242 226 227 227 227 227 227 227 227 227 228 229 230 212 211 0 0 0 0 212 257 257 257 257 257 257 257 257 257 0 0 0 0 0 0 
211 2 0 0 0 0 0 0 0 0 0 214 2 0 0 0 0 0 0 0 0 0 0 0 0 0 0 0 3 212 211 231 0 0 0 212 257 257 257 257 257 257 257 257 257 0 0 0 0 0 0 
211 2 0 0 232 233 233 233 233 233 234 214 213 0 0 0 0 0 0 0 0 0 0 0 0 0 0 0 3 212 211 0 0 0 0 212 257 257 257 257 257 257 257 257 257 0 0 0 0 0 0 
211 235 234 0 0 0 0 0 0 0 0 214 215 0 0 0 0 0 0 0 0 0 0 0 0 0 0 0 3 212 211 0 0 0 231 212 257 257 257 257 257 257 257 257 257 0 0 0 0 0 0 
211 2 0 0 0 0 0 0 0 0 0 214 219 220 221 222 223 224 225 226 227 227 227 227 230 0 0 0 3 212 211 0 0 0 0 212 257 257 257 257 257 257 257 257 257 0 0 0 0 0 0 
211 235 233 233 233 234 0 0 0 0 0 214 2 0 0 0 0 0 0 0 0 0 0 0 0 231 0 0 3 212 211 236 0 0 0 212 257 257 257 257 257 257 257 257 257 0 0 0 0 0 0 
211 2 0 0 0 0 0 231 0 0 0 215 2 0 0 0 0 0 0 0 0 0 0 0 0 0 0 231 3 212 211 0 0 0 231 212 257 257 257 257 257 257 257 257 257 0 0 0 0 0 0 
211 4 6 6 6 6 6 6 6 6 6 5 4 6 6 6 6 6 6 6 6 6 6 6 6 6 6 6 5 212 211 0 0 0 0 212 257 257 257 257 257 257 257 257 257 0 0 0 0 0 0 
200 202 202 202 202 202 202 202 202 202 202 202 202 202 202 202 202 202 202 202 202 202 202 202 202 202 202 202 202 201 200 202 202 202 202 201 257 257 257 257 257 257 257 257 257 0 0 0 0 0 0 
